Page1:
  capitalize: 首字母大写['kæpɪtəlaɪz] 
  justify: 两端对齐
  nowrap: 禁止自动换行
  reverse: 相反
  inverse: 相反
  horizontal: 水平的[hɒrɪ'zɒnt(ə)l] 
  initialism: 缩略词[ɪ'nɪʃ(ə)lɪz(ə)m] 
  condensed: 浓缩的
  striped: 有条纹的[straɪpt] 
  info: 信息['ɪnfəʊ] 
  thumbnail: 极小的['θʌmneɪl]
  renderer: 渲染器
  rendering engine: 浏览器内核
  trident: 三叉戟,IE内核 ['traɪd(ə)nt]
  gecko: 壁虎,firefox内核['gekəʊ]
  presto: 迅速的,opera内核['prestəʊ]
  Chakra: 脉轮,JS引擎['tʃʌkrə]
  chrome: 铬合金,谷歌浏览器[krəʊm]
  toggle: 开关,触发器['tɒg(ə)l] 
  stack: 堆
  pane: 窗格
  collapse: 倒塌[kə'læps]
  crumb: 碎片[krʌm]
  pagination: 分页[,pædʒɪ'neɪʃ(ə)n]
  pager: 寻呼机
  cursor: 光标 ['kɜːsə]
  jumbotron: 超大屏幕['dʒʌmbəutrɔn] 
  dismissible: 可解雇的[dɪs'mɪsəbl]
  panel: 面板['pæn(ə)l]
  caret: 插入符号['kærət]
  DNS: Domain Name System 域名系统
  shell: 壳[ʃel]
  sockets: 套接口['sɑkɪt]
  layer: 层['leɪə]
  layers: 图层面板['leɪəz]
  SSH: Secure Shell 安全外壳协议
  SSL: Secure Sockets Layer安全套接层
  Proxy: 代理人['prɒksɪ]
  halt: 停止[hɔːlt]
  reboot: 重新启动[riː'buːt]
  binary: 二进制的['baɪnərɪ]
  bandwith: 带宽
  RAM: random-access memory[ræm]  随机访问内存
  SSD: solid state disk
  groove: 凹槽[gruːv]
  ridge: 山脊
  thick: 厚的[θɪk]
  transparent: 透明的
  parentheses: 圆括号[pə'renθəsɪz]
  brackets: 方括号['brækɪt]
  curly braces: 花括号
  hexadecimal: 十六进制[,heksə'desɪm(ə)l]
  fixed: 确定的
  arithmetic: 算法[ə'rɪθmətɪk]
  operand: 操作数['ɒpərænd]
  exponentiation: 取幂[,ekspənenʃɪ'eɪʃ(ə)n] 
  decimals: 小数,十进位['dɛsɪml]
  primitive: 原始的
  parameter: 参数[pə'ræmɪtə]
  arguments: 参数['ɑːgjʊm(ə)nts]
  subroutine: 子程序 ['sʌbruːtiːn] 
  compute: 计算[kəm'pjuːt]
  scope: 范围[skəʊp] 
  backslash: 反斜杠['bækslæʃ] 
  complicate: 复杂化['kɒmplɪkeɪt] 
  extract: 提取[ˈekstrækt]
  slice: 切开[slaɪs]
  splice: 拼接[splaɪs]
  index: 指针['ɪndeks]
  immutable: 不变的[ɪ'mjuːtəb(ə)l]
  unicode: 双字节字符编码
  split: 分隔[splɪt]
  separator: 分离器['sepəreɪtə] 
  exponent: 指数[ɪk'spəʊnənt]
  notation: 符号[nəʊ'teɪʃ(ə)n]
  numeric: 数字[njuː'merɪk]
  octal: 八进制['ɒkt(ə)l]
  infinity: 无穷大[ɪn'fɪnɪtɪ]
  indicate: 指示['ɪndɪkeɪtɪŋ]
  literal: 文字的['lɪt(ə)r(ə)l]
  precision: 精度[prɪ'sɪʒ(ə)n] 
  internally: 内部的[in'tə:nəli]
  parse: 解析[pɑːz]
  relevant: 有意义的[ˈreləvənt]
  positive: 积极的
  round: 圆,循环[raʊnd] 
  floor: 地板[flɔː] 
  ceil: 装天花板[siːl]
  angle: 角度
  degree: 角度数
  redian: 弧度数['reɪdɪən]
  quotient: 商['kwəʊʃ(ə)nt]
  logarithm: 对数['lɒgərɪð(ə)m] 
  square: 平方的[skweə]
  root: 根
  capital: 大写字母['kæpɪt(ə)l]
  UTC: Coordinated Universal Time 协调世界时
  GMT: Greenwich Mean Time
  abbreviated: 简短的[ə'briːvɪeɪtɪd]
  wrap: 缠绕,外衣[ræp]
  dimensions: 规模[dɪ'menʃənz]
  align: 对齐,排列[ə'laɪn] 
  stretch: 伸展[stretʃ]
  decoration: 装饰[dekə'reɪʃ(ə)n]
  transform: 转化[trænsfə'meɪʃ(ə)n] 
  transition: 过渡
  animate: 有生命力的['ænɪmeɪt] 
  indent: 缩进[ɪn'dent]
  demonstrate: 证明,示范['demənstreɪt]
  character: 字符['kærəktə]
  overflow: 溢出[əʊvə'fləʊ]
  clip: 修剪[klɪp]
  ellipsis: 省略符号[ɪ'lɪpsɪs]
  embed: 使嵌入[ɪm'bed] 
  duplicate: 复制[ˈdjuːplɪkeɪt]
  invoke: 调用[ɪn'vəʊk]
  hoist: 提升[hɒɪst]
  comfigure: 安装[kən'fɪgə] 
  concat: 合并
  bitwise: 按位
  signed: 有符号的[saɪnd]
  sequence: 序列['siːkw(ə)ns]
  sensitive: 敏感的['sensɪtɪv]
  metacharacter: 元字符
  quantifier: 数量词['kwɒntɪfaɪə]
  boundary: 边界['baʊnd(ə)rɪ]
  assertion: 声明,主张[ə'sɜːʃ(ə)n]
  carriage: 运输['kærɪdʒ]
  precede: 领先[prɪ'siːd]
  backspace: 后退一格['bækspeɪs]
  inline: 内联的['ɪn,laɪn]
  semantic: 语义的[sɪ'mæntɪk]
  migrate: 移居[maɪ'greɪt; 'maɪgreɪt] 
  component: 组件[kəm'pəʊnənt]
  bundler: 打包机
  partial: 局部的 ['pɑːʃ(ə)l] 
  toggle: 开关['tɒg(ə)l]
  fade: 褪色[feɪd]
  slide: 滑动[slaɪd]
  chain: 链[tʃeɪn]
  descendant: 祖传的[dɪ'send(ə)nt]
  hyphen: 连字符['haɪf(ə)n]
  traverse: 穿过['trævəs; trə'vɜːs]
  asynchronous: 异步的[ə'sɪŋkrənəs; eɪ-]
  validity: 有效的[və'lɪdɪtɪ]
  verify: 核实['verɪfaɪ]
  intervals: 间隔['ɪntɚvl]
  prefix: 前缀['priːfɪks]
  rebust: 强健的[rə(ʊ)'bʌst]
  accordion: 可折叠[ə'kɔːdɪən] 
  widget: 装饰物 ['wɪdʒɪt] 
  template: 模板['templeɪt; -plɪt] 
  loader: 载入程序['ləʊdə]
  inject: 注入[ɪn'dʒekt]
  chunk: 大块[tʃʌŋk]
  fragment: 碎片['frægm(ə)nt]
  anchor: 锚['æŋkə] 
  strategy: 战略 [ˈstrætədʒɪ] 
  hybrid: 混血['haɪbrɪd]
  native: 本土
  Polyfill: 实现浏览器不支持的原生API代码
  iteration: 迭代,反复
  rotate: 旋转[rə(ʊ)'teɪt]
  skew: 偏离[skjuː]
  dimension: 方向,尺寸[dɪ'menʃ(ə)n]
  dpi: dots per inch每英寸点数(打印机)
  ppi: pixel per inch每英寸像素(显示屏)
    对于显示屏: 分辨率是通常用每英寸所含点或像素〔dpi〕来衡量
  dpcm: dots per centimeter每厘米点数
  schema: 模式；计划；图解；概要['skiːmə]
  pertain: 关于
  deprecated: 弃用,不赞成 [ˈdeprəkeɪtɪd]
  chunk: 大块
  issue: 问题
  stash: 存放[stæʃ]
  status: 状态 ['steɪtəs]
  property: 属性['prɒpətɪ]
  mount: 挂载[maʊnt]
  mustache: 胡子[mə'stɑːʃ]
  bind: 捆绑[baɪnd]
  handlebar: 车把,八字胡 ['hænd(ə)lbɑː] 
  uglify: 将..丑化['ʌɡlɪfaɪ]
  pedantic: 迂腐的[pɪ'dæntɪk]
  obscure: 模糊的,晦涩的[əb'skjʊə]
  sannitize: 给..消毒['sænɪtaɪz]
  conform: 符合[kən'fɔːm]
  philosophy: 哲学[fɪ'lɒsəfɪ] 
  concise: 简介的[kən'saɪs]
  implements: 履行,工具['ɪmplɪm(ə)nts]
  compatible: 兼容的[kəm'pætɪb(ə)l] 
  split: 分离[splɪt]
  ultimately: 基本上['ʌltɪmətlɪ]
  license: 许可证['laɪsns]
  copyright: 版权['kɒpɪraɪt]
  directive: 指令[dɪ'rektɪv; 
  awesome: 极好的['ɔːs(ə)m]
  fragments: 碎片['frægmənt]
  stuff: 材料[stʌf]
  notable: 值得注意的['nəʊtəb(ə)l]
  evaluate: 求值[ɪ'væljʊeɪt]
  caveat: 警告['kævɪæt]
  intentionally: 故意的[ɪn'tɛnʃənəli]
  recursively: 递归的[ri'kəsivli]
  bound: 限制[baʊnd]
  optimization: 最佳化[,ɒptɪmaɪ'zeɪʃən]
  stored: 存储的[stɔ: (r)d]
  runtime: 执行时间['rʌntæɪm]

Page2:
mutate: 变化[mjuː'teɪt]
process: 加工,处理['prəʊses]
preprocessor: 预处理器[,priː'prəʊsesə]
persistent: 持久稳固的[pə'sɪst(ə)nt]
progressive: 先进的[prə'gresɪv] 
manifest: 显示,货单['mænɪfest] 
identity: 身份[aɪ'dentɪtɪ] 
presentation: 展示,介绍[prez(ə)n'teɪʃ(ə)n]
storage: 仓库,存储['stɔːrɪdʒ]
orientation: 方向[,ɔːrɪən'teɪʃ(ə)n; 
prevent: 阻止[prɪ'vent]
reveal: 显示,揭露[rɪ'viːl]
pending: 待定['pendɪŋ]
initiator: 发起人,启动程序[ɪ'nɪʃɪeɪtə]
plaintext: 明文[pleɪn'tekst]
encrypt: 将..译成密码[en'krɪpt]
encryptor: 加密机
cipher: 密码['saɪfə]
cipher key: 密码索引
ciphertext: 密文
valid: 合法的['vælɪd]
modification: 修正,改变[,mɒdɪfɪ'keɪʃ(ə)n]
revert: 恢复原状[rɪ'vɜːt]
profile: 外形,轮廓['prəʊfaɪl]
placement: 布置['pleɪsmənt]
dock: 码头[dɒk]
throttle: 节流['θrɒt(ə)l]
prompt: 提示,迅速的[prɒm(p)t]
inspect: 检查[ɪn'spekt] 
infrastructure: 基础设施['ɪnfrəstrʌktʃə]
CLI: commom language infrastructure
applicable: 可适用的[ə'plɪkəb(ə)l; 'æplɪk-]
distribution: 分配[dɪstrɪ'bjuːʃ(ə)n]
terminal: 终端['tɜːmɪn(ə)l]
integrated: 综合的['ɪntɪgreɪtɪd]
ship: 运送[ʃɪp]
gutter: 槽,排水沟['gʌtə]
navigate: 驾驶,操作['nævɪgeɪt]
scaffold: 给..搭脚手架['skæfəʊld; -f(ə)ld]
generator: 发生器,生产者['dʒenəreɪtə]
gear: 齿轮,装置,工具[gɪə]
launch: 开始[lɔːntʃ]
attach: 附加[ə'tætʃ]
scalable: 可扩展 ['skeɪləb(ə)l]
sensor: 传感器['sensə]
descendent: 派生的[dɪ'sendənt]
expires: 到期[ɪk'spaɪəz]
landscape: 风景，地形，文件的横向打印格式[ˈlændskeɪp]
portrait: 肖像，描写['pɔːtrɪt]
ratio: 比例['reɪʃɪəʊ] 
instrumentation: 仪表化[,ɪnstrʊmen'teɪʃ(ə)n]
significant: 有意义的[sɪg'nɪfɪk(ə)nt] 
retina: 视网膜['retɪnə]
DPR: device pixel ratio 设备像素比例: 逻辑像素和物理像素的比例
emulate: 仿真，模仿['emjʊleɪt] 
implementation: 安装启用[ɪmplɪmen'teɪʃ(ə)n]
resume: 简历，(中断后)继续[rɪˈzjuːm; ˈrɛzjʊmeɪ]
step into|over|out of: 进入|跨过|跳出
blur: 使..模糊不清[blɜː]
abort: 使中止[ə'bɔːt]
exception: 异议[ɪk'sepʃ(ə)n; ek-]
hands-on: 亲身实践
overview: 综述，概观['əʊvəvjuː]
region: 地区，范围['riːdʒ(ə)n]
investigate: 调查，研究[ɪn'vestɪgeɪt]
consume: 消费，消耗[kən'sjuːm]
detect: 发现，探测 [dɪ'tekt]
indentation: 压痕[ɪnden'teɪʃ(ə)n]
compilation: 编译[kɒmpɪ'leɪʃ(ə)n]
reference: 参照，引用['ref(ə)r(ə)ns]
tedious: 冗长乏味的['tiːdɪəs]
thread: 衣服，路线[θred]
arrow: 箭头['ærəʊ]
closure: 关闭，中止['kləʊʒə] 
figure: 象征，描绘，人物['fɪgə]
outline: 概述，轮廓['aʊtlaɪn]
trace: 追溯[treɪs]
patch: 打补丁[pætʃ]
test out: 彻底检验
emphasis: 强调['emfəsɪs]
duration: 延迟,持续时间[djʊ'reɪʃ(ə)n]
vendor: 供应商['vendə; 'vendɔː] 
trend: 趋势，走向[trend]
bill: 账单[bɪl] 
coupon: 赠券['kuːpɒn]
hook: 挂钩[hʊk]
dashboard: 仪表盘
customize: 定做['kʌstəmaɪz]
milestone: 里程碑['maɪlstəʊn]
asignee: 代理人[æsɪ'niː; -saɪ-]
epic: 叙述诗['epɪk]
incognito: 匿名的[,ɪnkɒg'niːtəʊ; ɪn'kɒgnɪtəʊ]
profiler: 分析器['prəufailə]
screenshots: 画面，截屏
metrics: 度量['metrɪks]
overwhelming: 势不可挡的[,ovɚ'wɛlmɪŋ]
cue: 线索，暗示[kjuː]
scrubbing: 擦洗[’skrʌbɪŋ]
manually: 手动地['mænjʊəli]
boundary: 边界['baʊnd(ə)rɪ]
aggregate: 合计的['ægrigitid]
aggregatation: 聚合，集合体[,æɡrɪ'ɡeɪʃən]
executable: 可执行的[ɪg'zekjʊtəb(ə)l; eg-]
eval: 重新运算求出参数的内容[ɪ'væl]
emit: 发出，发表[ɪ'mɪt]
buffer: 缓冲区['bʌfə]
dirname: 目录名
directory: 目录[dɪ'rekt(ə)rɪ; daɪ-]
console: 控制台[kən'səʊl]
util: 跑龙套[ju'til]
collation: 校对[kə'leɪʃ(ə)n]
comply: 遵守[kəm'plaɪ]
convention: 协定[kən'venʃ(ə)n]
explicit: 明确的 [ɪk'splɪsɪt; ek-]
cap: 覆盖[kæp]
assert: 坚持，声称[ə'sɜːt]
reveal: 揭露 [rɪ'viːl]
trademark: 商标['treɪdmɑːk]
plain: 朴素的，简单的[pleɪn]
interpolation: 插入[ɪn,tɜːpəʊ'leɪʃən]
trailing: 拖尾的['treɪlɪŋ]
middleware: 中间件['midlwεə]
manner: 规矩，习惯['mænə]
downstream: 顺流的['daʊn'striːm]
filter: 过滤['fɪltə] 
manipulate: 操作[mə'nɪpjʊleɪt]
plural: 复数['plʊər(ə)l]
validator: 验证程序['vali,deitə]
mutate: 变化[mjuː'teɪt]
nest: 嵌套,鸟窝[nest]
sparse: 稀少的 [spɑːs]
assets: 资产，财务
preserve: 保留，保存[prɪ'zɜːv]
overlay: 覆盖图[əʊvə'leɪ]
skip: 跳跃[skɪp]
compress: 压缩[kəm'pres]
mangel: 损坏 ['mæŋg(ə)l]
identifiers: 标识符
suffix: 后缀['sʌfɪks]
mess: 杂乱[mes]
stands: 货摊，看台[stændz]
stats: 语句
shebang: 工作，住所[ʃɪ'bæŋ] 
override: 推翻，践踏[əʊvə'raɪd]
up-to-date: 最新的[,ʌp tə 'deɪt]
yarn: 故事，奇谈 [jɑːn] 
mutation: 突变[mjuː'teɪʃ(ə)n]
dispatch: 派遣，分派[dɪˈspætʃ]
assume: 假定[ə'sjuːm]
boilerplate: 样本模板['bɒɪləpleɪt]
piece: 块[piːs]
isolation: 隔离，孤立[aɪsə'leɪʃ(ə)n]
tricky: 狡猾的['trɪkɪ]
dynatic: 动态的[daɪ'næmɪk] 
loop: 循环[luːp] 
identical: 同一的 [aɪ'dentɪk(ə)l] 
shrink: 收缩[ʃrɪŋk]
hyperlink: 超链接[ˈhaɪpəlɪŋk] 
yield: 生产[ji:ld]
delimiter: 定界符[dɪ'lɪmɪtə]
predicate: 断定['predɪkət]
radius: 半径['reɪdɪəs]
radial: 放射状的['reɪdɪəl]
pie: 饼图[paɪ]
rectangular: 矩形[rek'tæŋgjʊlə]
diamond: 菱形['daɪəmənd]
vertical: 垂直的['vɜːtɪk(ə)l]
trigger: 触发['trɪgə]
scatter: 分散，散点['skætə]
mock: 仿制,模拟的[mɒk]
momotony: 单调[mə'nɒt(ə)nɪ]
simiulated: 模仿的['sɪmjʊleɪtɪd]
loosely: 宽松的['lu:slɪ]
pseudo: 假冒['sjuːdəʊ]
encapsulation: 封装[ɪn,kæpsə'leɪʃən]
preset: 预先装置
retrieve: 恢复，重新得到[rɪ'triːv]
fetch: 取得[fetʃ]
shiny: 晴朗的['ʃaɪnɪ]
fiddle: 瞎搞['fɪd(ə)l]
firm: 坚定的，牢固的[fɜːm]
teaser: 难题['tiːzə]
brain teaser: 脑筋急转弯
bit manipulation: 位操作
recursion: 递归[rɪ'kɜːʃ(ə)n] 
torrent: 连续不断['tɒr(ə)nt]
clause: 条款[klɔːz]
shorthand: 速记的['ʃɔːthænd]
hypotenuse: 直接三角形的斜边[haɪ'pɒtənjuːz; -s]
allocation: 分配[ælə'keɪʃ(ə)n]
comprise: 包含[kəm'praɪz]
kernel: 内核['kɜːn(ə)l]
tenant: 租户['tenənt] 
specialization: 专业化[,speʃəlaɪ'zeɪʃən]
composition: 组成
decompose: 分解
arbitrary: 随意的
premier: 第一的['premɪə]
stock: 库存
hierarchy: 等级制度
italicize: 用斜字体
modify: 修改
legacy: 遗弃
mutable: 易变的
